111111
100001
1E0CP1
111111