111111111
10C0C01C1
10P100101
101000001
111100101
1C0000E11
111111111